100 10
                                                                                                    |
                                      444                                       222                 |
                                     4   4                     333   TX       2    2X2X2 X X        |
                            3X2 3X  @     4                   4   T   @      2   Q--Q--Q--Q--  Z  @ |
                   Y4X 4X 4TQ--Q--Q--       #    Y  X         3 T   3       2             Y         |
       T 3Y3 3   YQ--Q--Q--  Z  X  Z X   2223333333333    X T X  X X2 2 2 Y      X  X       X  Y  X |
        Q--Q--Q--  T  X  22222222222222T2    4  T       TQ--Q--Q--Q--111Q--Q--222Q--Q--X  Q--Q--Q--Q|
  X     Y    @          1 X@     X   Y  Y@ Y  Y111Y111T11 @  X             X    @    X        X     |
O---------O---------O---------O---------O---------O---------O---------O---------O---------P-P-P-P-P-|
----------------------------------------------------------------------------------------------------|
                                                                                                    |
                                                                                                    |
  1232112                Y                                                                          |
   Q--Q--Q--Q-- Y    @      Q--Q--Q--Q--               Q--Q--Q--Q--          Q--Q--Q--Q--           |
     Y                Z                      Z             22222222321312312321312            21212 |
12322  X  X  12 X Z      X Y X Z Y           1111111111111           @        3123123134231231   @  |
--    Q--Q--Q--Q--     Q--Q--Q--Q--        Q--Q--Q--Q--      Q--Q--Q--Q--      Q--Q--Q--Q--         |
      @            1232             @                 @                           @                 |
O---------P-P-O---------P-P-O---------P-P-O---------P-P-O---------O---------O---------O---------P-P-|
----------------------------------------------------------------------------------------------------|
                                                                                                    |
                                                                                                    |
                                                                              4 4                   |
              @         2     3 3 3                3 3 3                3 3 3      3 3              |
                       1 2        X         @      T2 2                       3 3 3                 |
1 1 1 1 1 1   2 2 2   1   2 2        2 2   3   2 2       2 2   3    2 2                2 2 2   2 2 2|
     3 333333333333    Q--Q--Q--    2    @      X     X        Q--Q--Q--               @            |
1 1@1 1 1 1 1       1 1 1   1      X    1 1 1       YY   @  1 1 1                            1 1 1  |
O---------O---------O---------O---------O---------O---------O---------O---------O---------P-P-P-P-P-|
----------------------------------------------------------------------------------------------------|
                                                                                                    |
                                                                                                    |
                                                        4 4             TTT                         |
                     3 3 3                       3 3 3      3 3                                     |
            @                    3 3 3     @  Q--Q--Q-- 3 3                   @                     |
   2 2 2         2 2       2 2    Q--Q--Q--  2 2                 2 2 2           2 2                |
          Q--Q--Q--                                                                     22314242145 |
1         1 1 1      ZZ    @    Z1 1 1 1 1 1        ZZZZZZZZ @          1 1 1 1       1 1 1 1 1 1 1 |
O---------P-P-O---------P-P-O---------P-P-O---------P-P-O---------O---------O---------O---------P-P-|
----------------------------------------------------------------------------------------------------|
                                                                                                    |
                                                                                                    |
                                                                              4 4                   |
T   T   T  T                  3 3 3                3 3 3      TT        3 3 3      3 3              |
                      @                                   @                                  @      |
              2 2 2       2 2        2 2       2 2       2 2        2 2     Q--Q--Q--  2 2 2        |
           @                     @                                            @                     |
1 1 1 1 1 1 1       1 1 1 YY         YY  1 1 1      XXX      1 1 1        XXXXXXXXXXX         1 1 1 |
O---------O---------O---------O---------O---------O---------O---------O---------O---------P-P-P-P-P-|
----------------------------------------------------------------------------------------------------|
                                                                                                    |
                                                                                                    |
                                                        4 4                                         |
                     3 3 3                       3 3 3      3 3                                     |
             @                                                                                      |
   2 2 2         2 2       2 2    @          2 2                 2 2 2           2 2                |
                                                                                                    |
1         1 1 1     ZZZZZZ       1 1 1 1 1 1       XXXXXXXXXX           1 1 1 1       1 1 1 1 1 1 1 |
O---------P-P-O---------P-P-O---------P-P-O---------P-P-O---------O---------O---------O---------P-P-|
----------------------------------------------------------------------------------------------------|
                                                                                                    |
                                                                                                    |
                                                                                                    |
   TT                  TT           T        TT        T       T             TTTTTTT               |
                                                                                                    |
           Q--Q--Q--           22                                     3 3                           |
            1 1 1 1 1         2  2     2 2         2 2     2       2 2                              |
    11111111 1 1 1 1 111111111    11111            1 1 1 1           1 1 1                          |
O---------O---------O---------O---------O---------O---------O---------O---------O---------P-P-P-P-P-|
----------------------------------------------------------------------------------------------------|
                                                                                                    |
                                                                                                    |
                                                        4 4             TTT                         |
                     3 3 3                       3 3 3      3 3                                     |
            @                    3 3 3     @  Q--Q--Q-- 3 3                   @                     |
   2 2 2         2 2       2 2    Q--Q--Q--  2 2                 2 2 2           2 2                |
          Q--Q--Q--                                                                     22314242145 |
1         1 1 1      ZZ    @    Z1 1 1 1 1 1        ZZZZZZZZ @          1 1 1 1       1 1 1 1 1 1 1 |
O---------P-P-O---------P-P-O---------P-P-O---------P-P-O---------O---------O---------O---------P-P-|
----------------------------------------------------------------------------------------------------|
                                                                                                    |
                                                                                                    |
                                                                                                    |
                                                                                                    |
                                                                          4 4                       |
                                3 3 3                 3 3             3 3                           |
                  2 2 2       2       2 2         2 2     2       2 2                               |
    1 1 1 1 1 1 1       1 1 1             1 1 1 1           1 1 1                                   |
O---------O---------O---------O---------O---------O---------O---------O---------O---------P-P-P-P-P-|
----------------------------------------------------------------------------------------------------|
                                                                                                    |
                                                                                                    |
                                                        4 4             TTT                         |
                     3 3 3                       3 3 3      3 3                                     |
            @                    3 3 3     @  Q--Q--Q-- 3 3                   @                     |
   2 2 2         2 2       2 2    Q--Q--Q--  2 2                 2 2 2           2 2                |
          Q--Q--Q--                                                                     22314242145 |
1         1 1 1      ZZ    @    Z1 1 1 1 1 1        ZZZZZZZZ @          1 1 1 1       1 1 1 1 1 1 1 |
O---------P-P-O---------P-P-O---------P-P-O---------P-P-O---------O---------O---------O---------P-P-|
----------------------------------------------------------------------------------------------------|
                                                                                                    |
                                                         1 1                                        |
      x                                                1     1                                      |
                                         Q--Q--Q--Q--1         1               333                  |
 O---------         22222              2 2 2 2 2 2 2             2 2 2 2 2 2 232 23                 |
                1111     1 1 1 1 1 1 1       Q--Q--Q--Q--                    3     3 1 1 1 1        |
                  O---------             1 1 1 1 1 1 1 1 1 1 1 1 1 1 1      3       3        4 4 4 4|
   1 2 3 4 1 2 3 4 1 1 1 1 1 1 1 1 1 1 1                 ---             1 1         311            |
O---------O---------O---------O---------O---------O---------O---------O---------O---------P-P-P-P-P-|
----------------------------------------------------------------------------------------------------|
                                                                                                    |
                                                         1 1                                        |
      x                                                1     1                                      |
                                         Q--Q--Q--Q--1         1               333                  |
 O---------         22222              2 2 2 2 2 2 2             2 2 2 2 2 2 232 23                 |
                1111     1 1 1 1 1 1 1       Q--Q--Q--Q--                    3     3 1 1 1 1        |
                  O---------             1 1 1 1 1 1 1 1 1 1 1 1 1 1 1      3       3        4 4 4 4|
   1 2 3 4 1 2 3 4 1 1 1 1 1 1 1 1 1 1 1                 ---             1 1         311            |
O---------O---------O---------O---------O---------O---------O---------O---------O---------P-P-P-P-P-|
----------------------------------------------------------------------------------------------------|
                                                                                                    |
                                                         1 1                                        |
      x                                                1     1                                      |
                                         Q--Q--Q--Q--1         1               333                  |
 O---------         22222              2 2 2 2 2 2 2             2 2 2 2 2 2 232 23                 |
                1111     1 1 1 1 1 1 1       Q--Q--Q--Q--                    3     3 1 1 1 1        |
                  O---------             1 1 1 1 1 1 1 1 1 1 1 1 1 1 1      3       3        4 4 4 4|
   1 2 3 4 1 2 3 4 1 1 1 1 1 1 1 1 1 1 1                 ---             1 1         311            |
O---------O---------O---------O---------O---------O---------O---------O---------O---------P-P-P-P-P-|
----------------------------------------------------------------------------------------------------|
                                                                                                    |
                                                                                                    |
                                                        4 4             TTT                         |
                     3 3 3                       3 3 3      3 3                                     |
            @                    3 3 3     @  Q--Q--Q-- 3 3                   @                     |
   2 2 2         2 2       2 2    Q--Q--Q--  2 2                 2 2 2           2 2                |
          Q--Q--Q--                                                                     22314242145 |
1         1 1 1      ZZ    @    Z1 1 1 1 1 1        ZZZZZZZZ @          1 1 1 1       1 1 1 1 1 1 1 |
O---------P-P-O---------P-P-O---------P-P-O---------P-P-O---------O---------O---------O---------P-P-|
----------------------------------------------------------------------------------------------------|
                                                                                                    |
                                                                                                    |
                                                                                                    |
   TT                  TT           T        TT        T       T             TTTTTTT               |
                                                                                                    |
           Q--Q--Q--           22                                     3 3                           |
            1 1 1 1 1         2  2     2 2         2 2     2       2 2                              |
    11111111 1 1 1 1 111111111    11111            1 1 1 1           1 1 1                          |
O---------O---------O---------O---------O---------O---------O---------O---------O---------P-P-P-P-P-|
----------------------------------------------------------------------------------------------------|
                                                                                                    |
                                                                                                    |
                                                        4 4             TTT                         |
                     3 3 3                       3 3 3      3 3                                     |
            @                    3 3 3     @  Q--Q--Q-- 3 3                   @                     |
   2 2 2         2 2       2 2    Q--Q--Q--  2 2                 2 2 2           2 2                |
          Q--Q--Q--                                                                     22314242145 |
1         1 1 1      ZZ    @    Z1 1 1 1 1 1        ZZZZZZZZ @          1 1 1 1       1 1 1 1 1 1 1 |
O---------P-P-O---------P-P-O---------P-P-O---------P-P-O---------O---------O---------O---------P-P-|
----------------------------------------------------------------------------------------------------|